NO  ./textures/coche.xpm
SO  ./textures/coche.xpm
WE  ./textures/felix.xpm
EA  ./textures/felix.xpm

F 192,192,192
C 204,255,255

        1111111111111111111111111
        1000000000110000000000001
        1011000001110000000000001
        100100N000000000000000001
111111110001000001110000000000001
100000000011000001110111111111111
11110111111111011100000010001
11110111111111011101010010001
11000000110101011100000010001
10000000000000001100000010001
10000000000000001101010010001
1100000111010101111101111000111
11110111 1110101 101111010001
1000000000110000000000001
1011000001110000000000001
1001000000000000000000001
1111111100010000011100001
100000000011000001110111111111111
11110111111111011100000010001
11110111111111011101010010001
11000000110101011100000010001
10000000000000001100000010001
10000000000000001101010010001
1100000111010101111101111000111
11110111 1110101 101111010001
11111111 1111111 111111111111