NO  ./textures/castle.xpm
SO  ./textures/wall.xpm
WE  ./textures/felix.xpm
EA  ./textures/castle.xpm

F 102,51,0
C 0,0,0


11111111111111111111111111111
10101010101010101010101010101
11111111111110001000100010001
10101010101010101010101010101
10000000100000001000000000001
10101010000000000010101010101
10101010100011001010101010101
10101010100000001010101010101
10000000000000000000000000001
10000000100000001000000000001
10000000000000000000000000001
10101010100000001010101010101
10101010100000001010101010101
10101010000000000010101010101
10000000100000001000000000001
10101010101010101010101010101
10001000100010001000100010001
10101010101010101010101010101
10101010101010101010101010101
11111111111110001000100010001
10101010101010101010101010101
10000000100000001000000000001
10101010000000000010101010101
10101010100011001010101010101
10101010100000001010101010101
10000000000000000000000000001
10000000100000001000000000001
10000000000000000000000000001
10101010100000001010101010101
10101010100000001010101010101
10101010000000000010101010101
10000000100000001000000000001
10101010101010101010101010101
10001000100010001000100010001
10101010101010101010101010101
10101010101010101010101010101
11111111111110001000100010001
10101010101010101010101010101
10000000100000001000000000001
10101010000000000010101010101
10101010100011001010101010101
10101010100000001010101010101
10000000000000000000000000001
100000001000N0001000000000001
10000000000000000000000000001
10101010100000001010101010101
10101010100000001010101010101
10101010000000000010101010101
10000000100000001000000000001
10101010101010101010101010101
10001000100010001000100010001
10101010101010101010101010101
11111111111111111111111111111
