NO  ./textures/castle.xpm
SO  ./textures/wall.xpm
WE  ./textures/felix.xpm
EA  ./textures/castle.xpm

F 100,51,1
C 0,0,0

                                         11111111111111111
11111111              11111              10000000000000001
10000001             101001   111        10111100000011101
 1110001    1111     1010001110001       10100000000000101
10000001   100001    1000000000001       10100000000000101    11111111111111111
10001111   100001    1000011100001       10111111001111101    10000000000000001
100000001110001001111 1001   1001        101    1001   101    1000000000E000001
 1110001   1001000000100001110001        101    1001   101    10000000000000001
1000000111100010001000000001000111       101    1001   101    10111111111111111
 110000100001110010100111100010001       101    1111   10111111011
   1001 1001   1001001    100110111111111101           10000000011
   1001 1001    10001     100000000000000001           11111111111
   100010001     111       11111111111111111            1111111
   100000001
    1111111