NO ./textures/castle.xpm
SO ./textures/wall.xpm
WE ./textures/felix.xpm
EA ./textures/castle.xpm

F 220,100,2
C 225,255,255

11111111111111111111111111111
11111000000000000000000000001
10000000000000000000000000001
10000000000000000000000000001
10000000011111111110000000001
10000000000000000010000000001
10000000000000W00010000000001
10000000000000000010000000001
10000000000000000010000000001
10000000011111111110000000001
10000000000000000000000000001
10000000000000000000000000001
10000000000000000000000000001
10000000000000000000000000001
10000000000000000000000000001
11111111111111111111111111111
