NO ./textures/castle.xpm
SO ./textures/castle.xpm
WE ./textures/castle.xpm
EA ./textures/castle.xpm
F 51, 0, 0
C 0, 0, 0

1
11
101
1001
100001
10001
1N001
100001
1000011111 
1000000001
100010011 
11111111 
