NO  ./textures/castle.xpm
SO  ./textures/castle.xpm
WE  ./textures/castle.xpm
EA  ./textures/castle.xpm

F 153,76,0
C 204,255,255

11111111111111111111111111111
10000000000000000000000000001
10000000000000000000000000001
10000000000000000000000000001
10000100000000100000000100001
10000000000000000000000000001
10000000001000000000000000001
10000000000000000100000000001
10001000000000000000010000001
100000000000N0000000000000001
10000100000000000000000000001
10000000000000000000000000001
10000000000000000000000000001
10000000100000000000000000001
10000000000000000000000000001
11111111111111111111111111111
