NO  ./textures/castle.xpm
SO  ./textures/wall.xpm
WE  ./textures/felix.xpm
EA  ./textures/castle.xpm
F 184,113,39
C 51,198,227

11111111111111111111111111111
10000000001100000000000011111
10110000011100000000000011111
10010000000000000000000011111
11111111101100000111000011111
10000000001100000111011111111
11110111111111011100000010001
11110111111111011101010010001
11000000110101011100000010001
10000000000000001100000010001
10000000000000001101010010001
11000001110101011111000000N01
11110111111101011011110100011
11111111111111111111111111111
