NO  ./textures/castle.xpm
SO  ./textures/castle.xpm
WE  ./textures/castle.xpm
EA  ./textures/castle.xpm

F 182,182,182
C 204,255,255

1111111111111111
1110000000001111
1110110000011111

1110010000000011
1110000111101111
1110000000001111
1111110111111111
1111110111111111
1111000000110111
111000N000000011
1110000000000011
1111000001110111
1111111111111111
1111111111111111