1111111111111111111111
10000N0000000000000001
100E0000000100000N0001
10000000000110C0000001
1000000C00110000000001
1000110000111100000001
1000111000000000P00001
100001010C000000000001
100000000000000000N001
1111111111111111111111
