1111111111111111111111
1000000000000000000001
100E000000000000000001
10000000000000C0000001
1000000C00000000000001
1000000000000000000001
1000000000000000P00001
1000000000000000000001
1000000000000000000001
1111111111111111111111